############################
#p  i   1b* *    *   *  * *#
# # # #*# # #*#*# # # #*#*##
#   *      ***  *      *   #
# # o# # # #* # #*#*# # # ##
#f2   1      x ** *  *     #
# # # # # # # # # #*#1#*# ##
#*  *      *  *      *     #
# o # o #*# # # #*#*# # # ##
#*    **  *       *        #
# #*# # # # # # #*# # # # ##
# 1          *  *  *       #
############################

